[console_scripts]
dcd = COMDIRAC.Interfaces.scripts.dcd:main
dchgrp = COMDIRAC.Interfaces.scripts.dchgrp:main
dchmod = COMDIRAC.Interfaces.scripts.dchmod:main
dchown = COMDIRAC.Interfaces.scripts.dchown:main
dconfig = COMDIRAC.Interfaces.scripts.dconfig:main
dfind = COMDIRAC.Interfaces.scripts.dfind:main
dget = COMDIRAC.Interfaces.scripts.dget:main
dgetenv = COMDIRAC.Interfaces.scripts.dgetenv:main
dinit = COMDIRAC.Interfaces.scripts.dinit:main
dinput = COMDIRAC.Interfaces.scripts.dinput:main
dkill = COMDIRAC.Interfaces.scripts.dkill:main
dlogging = COMDIRAC.Interfaces.scripts.dlogging:main
dls = COMDIRAC.Interfaces.scripts.dls:main
dmeta = COMDIRAC.Interfaces.scripts.dmeta:main
dmkdir = COMDIRAC.Interfaces.scripts.dmkdir:main
doutput = COMDIRAC.Interfaces.scripts.doutput:main
dput = COMDIRAC.Interfaces.scripts.dput:main
dpwd = COMDIRAC.Interfaces.scripts.dpwd:main
drepl = COMDIRAC.Interfaces.scripts.drepl:main
dreplicas = COMDIRAC.Interfaces.scripts.dreplicas:main
drm = COMDIRAC.Interfaces.scripts.drm:main
drmdir = COMDIRAC.Interfaces.scripts.drmdir:main
dsetenv = COMDIRAC.Interfaces.scripts.dsetenv:main
dsize = COMDIRAC.Interfaces.scripts.dsize:main
dstat = COMDIRAC.Interfaces.scripts.dstat:main
dsub = COMDIRAC.Interfaces.scripts.dsub:main
dunsetenv = COMDIRAC.Interfaces.scripts.dunsetenv:main

[dirac]
metadata = COMDIRAC:extension_metadata
